+--+--+--+--+--+--+--+--+--+
               |        |  |
+--+--+  +--+  +  +--+  +  +
|     |  |  |  |  |     |  |
+  +  +  +  +--+--+  +--+  +
|  |  |  |  |     |     |  |
+  +--+  +  +--+  +  +  +  +
|           |  |     |     |
+--+--+  +--+  +--+--+--+  +
|     |     |  |        |  |
+  +  +  +  +  +  +--+  +  +
|  |     |  |     |     |  |
+  +--+--+  +--+--+  +--+  +
|        |     |     |     |
+--+--+  +--+  +  +--+--+--+
|           |     |        |
+  +--+--+  +--+--+  +--+  +
|        |        |  |     |
+--+--+  +  +  +  +  +  +--+
|        |     |     |      
+--+--+--+--+--+--+--+--+--+