+--+--+--+--+--+--+--+--+--+
               |        |  |
+--+--+  +--+  +  +--+  +  +
|     |     |  |        |  |
+  +  +  +  +  +  +--+  +  +
|  |     |  |     |     |  |
+  +--+--+  +--+--+  +--+  +
|        |  |  |     |     |
+--+--+  +--+  +  +--+--+--+
|           |     |        |
+  +--+--+  +--+--+  +--+  +
|        |  |     |  |     |
+--+--+  +  +  +  +  +  +--+
|        |     |     |      
+--+--+--+--+--+--+--+--+--+